###########
#      PPP#
# ### ###P#
# #     #P#
# #P###P#P#
#P#  G  # #
#P####### #
#    S    #
###########