##############
#P    G     P#
#            #
#            #
#            #
#            #
#            #
#     S      #
#            #
#            #
#            #
#           P#
#          PP#
#PP       PPP#
##############