#############
#G#    #   P#
#    #   #  #
######## # P#
#P     ###PP#
#   #    #PP#
#S P#PP#    #
#############