#############
#     P    G#
#     P     #
#PPPPPP     #
#     P     #
#S    P     #
#############