####################
#              #   #
# ############ # #P#
# #          # # # #
# # ######## # # # #
# # #      # # # # #
# # ## ### # # # # #
# #    #   # # #S# #
# # ######## # ### #
# # #      # #     #
# ### #### # #####P#
#   #  P # #     # #
#P#P#  # # #  #### #
# # #  # # #       #
### #PP# # # #######
#   #PG# # # #     #
# # # ## # # #  ## #
# # # P P# # #   # #
# #####  # # ##### #
#        # #       #
####################