#############################
# # # # # #P# # # # # # # #G#
#                           #
## # # # #P#P# # # # # # # ##
#P   P ######################
# # # # # # # # # # # # # # #
# # # # # # # # # # # # # # #
#                         P #
## # # # # # # # # # # # # ##
#S                     PPPP #
#############################