###########
#P       P#
# ### ### #
# #     # #
# #P###P# #
# #  G  # #
# ####### #
#    S    #
###########