#############
#           #
#P## # ######
#    #     P#
#    #     G#
##  #########
#           #
#          S#
#############