#############
#P         G#
# P         #
#  P       P#
#  P      PP#
#S       PPP#
#############