#############
#           #
#  ### ###  #
#  #     #  #
#  # ### #  #
#  #  G  #  #
#  #######  #
#     S     #
#############