#######
#  G  #
# # # #
# # # #
# #P# #
#     #
# ### #
# #P  #
# # ###
#    S#
#######