#######
# #G# #
# P P #
# # # #
# P P #
# # # #
# P P #
# # #P#
#  S  #
#######