###################
# # # # # # # # #G#
#                 #
## # # # # # # # ##
#                 #
# # # # # # # # # #
#                 #
##P# # # # # # # ##
#                 #
# # # # # # # # # #
#                 #
## # # #P# # # # ##
#S                #
###################