#############
#          G#
#           #
#     P     #
#           #
#S          #
#############