####################
#              #   #
# ############ # # #
# #          # # # #
# # ######## # # # #
# # #      # # # # #
# # ## ### # # # # #
# #    #   # # #S# #
# # ######## # ### #
# # #      # #     #
# ### #### # ##### #
#   #    # #     # #
# # #  # # #  #### #
# # #  # # #       #
### #  # # # #######
#   # G# # # #     #
# # # ## # # #  ## #
# # #    # # #   # #
# #####  # # ##### #
#        # #       #
####################