#####################################
# #       #       #     #         #S#
# # ##### # ### ##### ### ### ### # #
#       #   # #     #     # # #   # #
##### # ##### ##### ### # # # ##### #
#   # #       #     # # # # #     # #
# # ####### # # ##### ### # ##### # #
# #       # # #   #     #     #   # #
# ####### ### ### # ### ##### # ### #
#     #   # #   # #   #     # #     #
# ### ### # ### # ##### # # # #######
#   #   # # #   #   #   # # #   #   #
####### # # # ##### # ### # ### ### #
#     # #     #   # #   # #   #     #
# ### # ##### ### # ### ### ####### #
# #   #     #     #   # # #       # #
# # ##### # ### ##### # # ####### # #
# #     # # # # #     #       # #   #
# ##### # # # ### ##### ##### # #####
# #   # # #     #     # #   #       #
# # ### ### ### ##### ### # ##### # #
#G#    P    #     #       #       # #
#####################################