################################
#              #       #S      #
#  # # ######  #  ## # ######  #
#  # # #       #   # #         #
#  # ########### ### ###########
#  # #         # # #           #
#  # # ####### # # ########### #
#  # # #     #   #   #       # #
#  # # # #########  ##  #### # #
#  # # # #                 # # #
#### # # # ################# # #
#    # # # # #   #           # #
###  # # # # # # # ##  ####### #
#    # # # #   # # #   #       #
#  # # # # ##### # ### # ##### #
#  # # # #       # # # # #   # #
#  ### # ####### # # # # # # # #
#  #   #       # # # # # # #   #
#  # ######### # # # # # #######
#  # #       # # # # # #       #
#  # # ####  # # # # # ####### #
#  # # #       # # # # #     # #
#  # # ######### # # # # # ### #
#    #           # # # # # #   #
#### # ########### # # ### # # #
#  # # # #         #       # # #
#  # # # # ### ############# ###
#    #   # # # #           #   #
#  P###### # # # ####  ##  ##  #
#G         #   # #     #       #
################################