###########################################
#     #     #                             #
# ### # ##### ################### ####### #
#   #   #     #   #   #         #   #     #
### # ### ##### # # # # ####### ### # #####
#   # #   #     #   # #     # # #   #   # #
# ### # ### ############# ##### ####### ###
# #   # # # #         # # #   #     # #   #
# ##### ### # ####### # # # # ### # ##### #
#     # #   #   #   # # #   #   # #       #
# ### # # ##### ### # ######### # #########
# #   # #     #   # #         # #       # #
# # ### ######### # ######### # ### ### ###
# # #             #         # #   # # #   #
# # # ############### ##### # ### # # ### #
# #     #   #             # #   # #   #   #
# ##### # # # ### ##### ##### # # ### # ###
# #     # # #   #     # #     # # # # #   #
# # ##### # ### # ####### ####### # # ### #
# # #     #   # #   #   #       # #   # # #
# # # ######### ### # ######### # ####### #
# #               # #   # # #   #     # # #
# # ################### ##### ####### ### #
# #     #   # #     # # # #         # #   #
####### # # # # ### ### ### ### ##### # ###
#   #   # # # # # #     # # #   #   # #   #
# ### ### # # # ########### # ### # # #####
#       # # # #           # # #   # #     #
####### ### # ########### # # ########### #
#S          #           #   #         #G  #
###########################################