#############################
# # # # # # # # # # # # # #G#
#                           #
## # # # # # # # # # # # # ##
#      ######################
# # # # # # # # # # # # # # #
# # # # # # # # # # # # # # #
#                           #
## # # # # # # # # # # # # ##
#S                          #
#############################