#############################
# # # # # # # # # # # # # #G#
#                           #
## # # # # # # # # # # # # ##
#P   P ######################
# # # # # # # # # # # # # # #
# # # # # # # # # # # # # # #
#                         P #
## # # # # # # # # # # # # ##
#S                          #
#############################