##############
#     G      #
#            #
#            #
#            #
#            #
#            #
#     S      #
#            #
#            #
#            #
#            #
##############
##          ##
##############