###########
#         #
# ### ### #
# #     # #
# # ### # #
# #  G  # #
# ####### #
#    S    #
###########