#############
#G#    #    #
#    #   #  #
######## #  #
#      ###  #
#   #    #  #
#S  #  #    #
#############